Факультет   :: s-аудит: N1 -m-> (Тип s-місць:N1)
               s-склад: НФО -m-> ФізичОсоба
			   Навчання 
			   s-кафедри: Назва -m-> Кафедра
			   s-друк:НДП -m-> Друкована
Навчання    :: s-студ:Потік -m-> ([N1] -m-> НФО-set) 
               s-учбпл:Потік -m-> (Назва -m-> Дисципліна)
			   s-наван:Предмет  -m->  Виконавець
			   s-розклад:Місце -m-> (Предмет НФО) 
			   
Тип         =  Семінар | Практика
НФО, НДП    = N1
ФізичОсоба  :: ПІБ Адреса Телефон Стать
ПІБ, Адреса, Телефон  = ....
Стать       = Чол | Жін	

Потік       :: Спеціальн s-рік:N1 s-сем:N1  
Спеціальн   = ... 
Назва       = ....
Дисципліна  :: УчбовНапр (ТипГодин -m-> N1)
ТипГодин    =  Лекція | Семінар | Практика | Екзамен | Індивід

Предмет     :: ТипГодин Назва УчбоваОдин
УчбоваОдин  =  Потік | Група | НФО
Група       :: Потік [N1]
Виконавець   = Назва | НФО
Місце       :: s-номер:N1 День s-пара:N1   
День         = Пон | Вівт | Сер | Четв | Пятн 

Кафедра     :: s-зав:[НФО] s-вик:НФО -m-> Викладач s-ас:НФО -m-> Аспірант 
Викладач    :: НауковНапр УчбовНапр Посада НаукСтепінь
НауковНапр, УчбовНапр, Посада, НаукСтепінь = ....
Аспірант    :: НауковНапр s-рік:N1 

Друкована   :: НФО-set Назва НауковНапр s-рік:N1 Вид
Вид         = Тези | Підручник | Монографія | Стаття 		   
   
			   


Факультет   :: Склад Кафедри Студенти Навчання Аудиторії ДрукованіРоботи
Склад        = НФО -m->  ФізичнаОсоба
Кафедри      = Назва -m-> Кафедра
Студенти     = Потік -m-> ([N1] -m-> НФО-set)
Навчання    :: УчбовіПлани Навантаження Розклад
УчбовіПлани  = Потік -m-> (Назва -m-> Дисципліна)
Навантаження = Предмет  -m->  Виконавець
Розклад      = Місце  -m-> (Предмет НФО) 
Аудиторії    = N1 -m-> (Тип s-місць:N1)
ДрукованіРоботи = НДП -m-> ДрукованаПраця 



